barcelona|barna|bar.na
buenos aires|bs as|bs.as
capital federal|cap fed
ciudad de méxico|c méx|c mex|c de méx|c de mex|ciudad de mexico|cdmx
distrito federal|df|d.f|d f
distrito capital|dc|d.c|d c
distrito nacional|dn|d.n|d n
madrid|madd
aguascalientes|ag|ags
baja california|bn|bc
baja california sur|bs|bcs
campeche|cm|cam|camp
chiapas|ca|chps|chia
chihuahua|ch|chi
coahuila|ca|coa|coah
colima|cl|col
durango|du|dur
guanajuato|gt|gto
guerrero|gr|gue
hidalgo|hi|hgo|hid
jalisco|ja|jal
méxico|mexico|mx|mex
michoacán|michoacan|mc|mic|mich
morelos|mr|mor
nayarit|na|nay
nuevo león|nuevo leon|nl|nvo. león|nvo. leon
oaxaca|oa|oax
puebla|pu|pue
querétaro|queretaro|qe|que|qro
quintana roo|qr|qroo|q. roo
san luis potosí|san luis potosi|sl|slp
sinaloa|si|sin
sonora|so|son
tabasco|tb|tab
tamaulipas|tm|tam|tamps
tlaxcala|tl|tla|tlx
veracruz|ve|ver
yucatán|yucatan|yu|yuc
zacatecas|za|zac